15 30
                           
 S                       O  
                            
---------   -------- ------- 
    H                 H     
    H                 H     
    H                 H     
    H            ------------
 --------         H         
       H          H         
       H          H         
       H          H          
      ----------------      
